╔══════════════════════════════╗
║..............................║
║..............................║
║..............................║
║..............................║
║..............................║
║..............................║
║..............................║
║..............................║
║..............................║
║..............................║
║..............................║
║..............................║
║..............................║
║..............................║
>..............................>
║..............................║
║..............................║
║..............................║
║..............................║
║..............................║
║..............................║
║..............................║
║..............................║
║..............................║
║..............................║
║..............................║
║..............................║
║..............................║
║..............................║
║..............................║
╚══════════════════════════════╝