╔══════════════════════════════╗
║..............................║
║.▉▉▉▉▉▉▉▉▉▉▉▉▉▉▉▉▉▉▉▉▉▉▉▉▉▉▉▉.║
║.▉..........................▉.║
║.▉.▉▉▉▉▉▉▉▉▉▉▉▉▉▉▉▉▉▉▉▉▉▉▉▉.▉.║
║.▉........................▉.▉.║
║.▉▉▉▉▉▉▉▉▉▉▉▉▉▉▉▉▉▉▉▉▉▉▉▉.▉.▉.║
║.▉......................▉.▉.▉.║
║.▉.▉▉▉▉▉▉▉▉▉▉▉▉▉▉▉▉▉▉▉▉.▉.▉.▉.║
║.▉....................▉.▉.▉.▉.║
║.▉▉▉▉▉▉▉▉▉▉▉▉▉▉▉▉▉▉▉▉.▉.▉.▉.▉.║
║.▉..................▉.▉.▉.▉.▉.║
║.▉.▉▉▉▉▉▉▉▉▉▉▉▉▉▉▉▉.▉.▉.▉.▉.▉.║
║.▉................▉...▉...▉...║
║.▉▉▉▉▉▉▉▉▉▉▉▉▉▉▉▉.▉▉▉▉▉▉▉▉▉▉▉▉║
║.▉................▉▉▉...▉...▉▉║
>.▉.▉▉▉▉▉▉▉▉▉▉▉▉▉▉▉▉▉▉.▉.▉.▉...>
║▉▉.▉...▉...▉...▉...▉..▉.▉.▉▉▉▉║
║...▉.▉...▉...▉...▉...▉▉...▉...║
║.▉▉▉.▉▉▉▉▉▉▉▉▉▉▉▉▉▉▉▉▉▉▉▉▉▉.▉.║
║.▉▉▉......................▉.▉.║
║.▉▉▉▉▉▉▉▉▉▉▉▉▉▉▉▉▉▉▉▉▉▉▉▉.▉.▉.║
║.▉........................▉.▉.║
║.▉.▉▉▉▉▉▉▉▉▉▉▉▉▉▉▉▉▉▉▉▉▉▉▉▉.▉.║
║.▉........................▉.▉.║
║.▉▉▉▉▉▉▉▉▉▉▉▉▉▉▉▉▉▉▉▉▉▉▉▉.▉.▉.║
║.▉........................▉.▉.║
║.▉.▉▉▉▉▉▉▉▉▉▉▉▉▉▉▉▉▉▉▉▉▉▉▉▉.▉.║
║.▉..........................▉.║
║.▉▉▉▉▉▉▉▉▉▉▉▉▉▉▉▉▉▉▉▉▉▉▉▉▉▉▉▉.║
║..............................║
╚══════════════════════════════╝
